NO ./img/Abstract_128x128-09.xpm
SO ./img/Abstract_128x128-18.xpm
WE ./img/Abstract_128x128-25.xpm
EA ./img/Abstract_128x128-47.xpm

F 010, 255, 255
C 150, 105, 200


        1111111111111111111111111
        1000000000110000000000001
        1011000001110000000000001
        1001000000000000000000001
111111111011000001110000000000001
100000000011000001110111111111111
11110111111111011100000000001
11110111111111011101010010001
11000000110101011100000010001
10000000000000001100000010001
100000000000000000000000W0001
1100000111010101110101000010111
11110111 1110101 101110000001
11111111 1111111 111111111111